{
  "levelsList": [
     ["         ",
      "         ",
      "        f",
      "       bb",
      "         ",
      "         ",
      "         ",
      "         "],

     ["         ",
      "         ",
      "    f    ",
      "  cbbb   ",
      "         ",
      "         ",
      "         ",
      "         "],

     ["f        ",
      "bb       ",
      "       f ",
      "       b ",
      "         ",
      "         ",
      "         ",
      "         "],

     ["         ",
      "         ",
      "         ",
      "  cbfbc  ",
      " b bbb   ",
      "         ",
      "         ",
      "         "],

     ["fbcfbcfbc",
      "    f    ",
      "    b    ",
      "    c    ",
      "    f    ",
      "    b    ",
      "    c    ",
      "    f    "],

    ["         ",
      "         ",
      "        f",
      "  bbbbbbb",
      "         ",
      "bbbbbbb  ",
      "         ",
      "  bbbbbbb"],

    ["         ",
      "         ",
      "    f    ",
      "  cbbb   ",
      "         ",
      "         ",
      "         ",
      "         "],

    ["f        ",
      "bb       ",
      "       f ",
      "       b ",
      "         ",
      "         ",
      "         ",
      "         "],

    ["         ",
      "         ",
      "         ",
      "  cbfbc  ",
      " b bbb   ",
      "         ",
      "         ",
      "         "],

    ["fbcfbcfbc",
      "    f    ",
      "    b    ",
      "    c    ",
      "    f    ",
      "    b    ",
      "    c    ",
      "    f    "],

    ["         ",
      "         ",
      "        f",
      "       bb",
      "         ",
      "         ",
      "         ",
      "         "],

    ["         ",
      "         ",
      "    f    ",
      "  cbbb   ",
      "         ",
      "         ",
      "         ",
      "         "],

    ["f        ",
      "bb       ",
      "       f ",
      "       b ",
      "         ",
      "         ",
      "         ",
      "         "],

    ["         ",
      "         ",
      "         ",
      "  cbfbc  ",
      " b bbb   ",
      "         ",
      "         ",
      "         "],

    ["fbcfbcfbc",
      "    f    ",
      "    b    ",
      "    c    ",
      "    f    ",
      "    b    ",
      "    c    ",
      "    f    "],

    ["         ",
      "         ",
      "        f",
      "       bb",
      "         ",
      "         ",
      "         ",
      "         "],

    ["         ",
      "         ",
      "    f    ",
      "  cbbb   ",
      "         ",
      "         ",
      "         ",
      "         "],

    ["f        ",
      "bb       ",
      "       f ",
      "       b ",
      "         ",
      "         ",
      "         ",
      "         "],

    ["         ",
      "         ",
      "         ",
      "  cbfbc  ",
      " b bbb   ",
      "         ",
      "         ",
      "         "],

    ["fbcfbcfbc",
      "    f    ",
      "    b    ",
      "    c    ",
      "    f    ",
      "    b    ",
      "    c    ",
      "    f    "],

    ["         ",
      "         ",
      "        f",
      "       bb",
      "         ",
      "         ",
      "         ",
      "         "],

    ["         ",
      "         ",
      "    f    ",
      "  cbbb   ",
      "         ",
      "         ",
      "         ",
      "         "],

    ["f        ",
      "bb       ",
      "       f ",
      "       b ",
      "         ",
      "         ",
      "         ",
      "         "],

    ["         ",
      "         ",
      "         ",
      "  cbfbc  ",
      " b bbb   ",
      "         ",
      "         ",
      "         "],

    ["fbcfbcfbc",
      "    f    ",
      "    b    ",
      "    c    ",
      "    f    ",
      "    b    ",
      "    c    ",
      "    f    "]

  ]
}